000000010000000000000000000000000000000000000000000001010010220000
000002000010000000000000000000000000000000000000000001010010220000
000000000000000000000000000000000000000000000000000001010010220000
000000000000000000100020000000000000000000000000000001010010220000
000000000000002000000000000000000000000000000000000001010010220000
000000000000000100000000000000000000000000000000000001010010220000
000000000000001000200000000000000000000000000000000001010010220000
000000000000000000000000000000000000000000000000000001010010220000
000002000000000000000000010000000000000000000000000001010010220000
000000000000000000000000000000000000000000000000000001010010220000
000000000000000000000020000000000000000000000000000001010010220000
000000000000000000000000000000000000000000000000000001010010220000
000000000000000000000010000000000000000000000000000001010010220000
000000000000000000000000000000000000000000000000000001010010220000
000000000000000000000000000000000000000000000000000001010010220000
000000000000000000000000000000000000000000000000000001010010220000
000000000000000000000000000000000000000000000000000001010010220000
000000000000000000000000000000000000000000000000000001010010220000
